-60
-60
30
wwwwwwwww
w w w w w
w   w   w
w w   w
wbw w w w
w w w w w
wwwwwwwww
